[level]
tileset = resources/gfx/tilesets/tiles1.png
tilewidth = 32
tileheight = 32
blockedtiles = 5,0,16,0,16,1,5,2,6,2,7,2,8,2,9,2,10,2,11,2,12,2,13,2,14,2,15,2,16,2,17,2,18,2,19,2,20,2,21,2,22,2,23,2,24,2,25,2,26,2,27,2,28,2,29,2,30,2,5,3,1,4,2,4,3,4,4,4,5,4,1,5,7,5,8,5,9,5,10,5,12,5,13,5,14,5,15,5,16,5,17,5,18,5,19,5,20,5,21,5,22,5,23,5,24,5,25,5,26,5,27,5,29,5,30,5,31,5,7,6,10,6,17,6,24,6,27,6,29,6,1,7,2,7,3,7,4,7,5,7,6,7,7,7,10,7,17,7,18,7,19,7,20,7,24,7,27,7,29,7,10,8,17,8,24,8,27,8,29,8,1,9,10,9,17,9,19,9,20,9,21,9,22,9,23,9,24,9,27,9,29,9,1,10,2,10,3,10,4,10,6,10,7,10,8,10,9,10,10,10,17,10,20,10,27,10,29,10,1,11,4,11,6,11,10,11,11,11,12,11,13,11,14,11,15,11,17,11,18,11,20,11,27,11,29,11,1,12,4,12,6,12,20,12,27,12,29,12,1,13,4,13,6,13,7,13,8,13,9,13,10,13,11,13,12,13,13,13,14,13,15,13,17,13,18,13,19,13,20,13,21,13,23,13,24,13,27,13,1,14,4,14,11,14,24,14,27,14,29,14,1,15,4,15,11,15,21,15,24,15,27,15,29,15,1,16,4,16,5,16,7,16,8,16,9,16,10,16,11,16,17,16,18,16,20,16,21,16,24,16,27,16,29,16,1,17,11,17,17,17,21,17,24,17,27,17,29,17,1,18,2,18,3,18,4,18,5,18,7,18,11,18,17,18,21,18,24,18,27,18,29,18,1,19,7,19,11,19,17,19,24,19,29,19,1,20,5,20,7,20,11,20,12,20,13,20,14,20,15,20,16,20,17,20,18,20,19,20,20,20,21,20,22,20,23,20,24,20,25,20,26,20,27,20,28,20,29,20,1,21,2,21,3,21,4,21,5,21,7,21,21,21,1,22,7,22,21,22,1,23,7,23,21,23,00
[fringe1]
map = 63,63,63,63,63,46,63,63,63,63,63,63,63,63,63,63,46,63,63,63,63,63,63,63,63,63,63,63,63,63,63,63
      63,63,63,63,63,63,63,63,63,63,63,63,63,63,63,63,46,63,63,63,63,63,63,63,63,63,63,63,63,63,63,63
      63,63,63,63,63,46,46,46,46,46,46,46,46,46,46,46,46,46,46,46,46,46,46,46,46,46,46,46,46,46,46,63
      63,63,63,63,63,46,63,63,63,63,63,63,63,63,63,63,63,63,63,63,63,63,63,63,63,63,63,63,63,63,63,63
      63,46,46,46,46,46,63,63,63,63,63,63,63,63,63,63,63,63,63,63,63,63,63,63,63,63,63,63,63,63,63,63
      63,46,63,63,63,63,63,46,46,46,46,63,46,46,46,46,46,46,46,46,46,46,46,46,46,46,46,46,63,46,46,46
      63,63,63,63,63,63,63,46,63,63,46,63,63,63,63,63,63,46,63,63,63,63,63,63,46,63,63,46,63,46,63,63
      63,46,46,46,46,46,46,46,63,63,46,63,63,63,63,63,63,46,46,46,46,63,63,63,46,63,63,46,63,46,63,63
      63,63,63,63,63,63,63,63,63,63,46,63,63,63,63,63,63,46,63,63,63,63,63,63,46,63,63,46,63,46,63,63
      63,46,63,63,63,63,63,63,63,63,46,63,63,63,63,63,63,46,63,46,46,46,46,46,46,63,63,46,63,46,63,63
      63,46,46,46,46,63,46,46,46,46,46,63,63,63,63,63,63,46,63,63,46,63,63,63,63,63,63,46,63,46,63,63
      63,46,63,63,46,63,46,63,63,63,46,46,46,46,46,46,63,46,46,63,46,63,63,63,63,63,63,46,63,46,63,63
      63,46,63,63,46,63,46,63,63,63,63,63,63,63,63,63,63,63,63,63,46,63,63,63,63,63,63,46,63,46,63,63
      63,46,63,63,46,63,46,46,46,46,46,46,46,46,46,46,63,46,46,46,46,46,63,46,46,63,63,46,63,63,63,63
      63,46,63,63,46,63,63,63,63,63,63,46,63,63,63,63,63,63,63,63,63,63,63,63,46,63,63,46,63,46,63,63
      63,46,63,63,46,63,63,63,63,63,63,46,63,63,63,63,63,63,63,63,63,46,63,63,46,63,63,46,63,46,63,63
      63,46,63,63,46,46,63,46,46,46,46,46,63,63,63,63,63,46,46,63,46,46,63,63,46,63,63,46,63,46,63,63
      63,46,63,63,63,63,63,63,63,63,63,46,63,63,63,63,63,46,63,63,63,46,63,63,46,63,63,46,63,46,63,63
      63,46,46,46,46,46,63,46,63,63,63,46,63,63,63,63,63,46,63,63,63,46,63,63,46,63,63,46,63,46,63,63
      63,46,63,63,63,63,63,46,63,63,63,46,63,63,63,63,63,46,63,63,63,63,63,63,46,63,63,63,63,46,63,63
      63,46,63,63,63,46,63,46,63,63,63,46,46,46,46,46,46,46,46,46,46,46,46,46,46,46,46,46,46,46,63,63
      63,46,46,46,46,46,63,46,63,63,63,63,63,63,63,63,63,63,63,63,63,46,63,63,63,63,63,63,63,63,63,63
      63,46,63,63,63,63,63,46,63,63,63,63,63,63,63,63,63,63,63,63,63,46,63,63,63,63,63,63,63,63,63,63
      63,46,63,63,63,63,63,46,63,63,63,63,63,63,63,63,63,63,63,63,63,46,63,63,63,63,63,63,63,63,63,63
      
[layer2]
map = 63,63,63,63,63,46,63,63,63,63,63,63,63,63,63,63,46,63,63,63,63,63,63,63,63,63,63,63,63,63,63,63
      63,63,63,63,63,63,63,63,63,63,63,63,63,63,63,63,46,63,63,63,63,63,63,63,63,63,63,63,63,63,63,63
      63,63,63,63,63,46,46,46,46,46,46,46,46,46,46,46,46,46,46,46,46,46,46,46,46,46,46,46,46,46,46,63
      63,63,63,63,63,46,63,63,63,63,63,63,63,63,63,63,63,63,63,63,63,63,63,63,63,63,63,63,63,63,63,63
      63,46,46,46,46,46,63,63,63,63,63,63,63,63,63,63,63,63,63,63,63,63,63,63,63,63,63,63,63,63,63,63
      63,46,63,63,63,63,63,46,46,46,46,63,46,46,46,46,46,46,46,46,46,46,46,46,46,46,46,46,63,46,46,46
      63,63,63,63,63,63,63,46,63,63,46,63,63,63,63,63,63,46,63,63,63,63,63,63,46,63,63,46,63,46,63,63
      63,46,46,46,46,46,46,46,63,63,46,63,63,63,63,63,63,46,46,46,46,63,63,63,46,63,63,46,63,46,63,63
      63,63,63,63,63,63,63,63,63,63,46,63,63,63,63,63,63,46,63,63,63,63,63,63,46,63,63,46,63,46,63,63
      63,46,63,63,63,63,63,63,63,63,46,63,63,63,63,63,63,46,63,46,46,46,46,46,46,63,63,46,63,46,63,63
      63,46,46,46,46,63,46,46,46,46,46,63,63,63,63,63,63,46,63,63,46,63,63,63,63,63,63,46,63,46,63,63
      63,46,63,63,46,63,46,63,63,63,46,46,46,46,46,46,63,46,46,63,46,63,63,63,63,63,63,46,63,46,63,63
      63,46,63,63,46,63,46,63,63,63,63,63,63,63,63,63,63,63,63,63,46,63,63,63,63,63,63,46,63,46,63,63
      63,46,63,63,46,63,46,46,46,46,46,46,46,46,46,46,63,46,46,46,46,46,63,46,46,63,63,46,63,63,63,63
      63,46,63,63,46,63,63,63,63,63,63,46,63,63,63,63,63,63,63,63,63,63,63,63,46,63,63,46,63,46,63,63
      63,46,63,63,46,63,63,63,63,63,63,46,63,63,63,63,63,63,63,63,63,46,63,63,46,63,63,46,63,46,63,63
      63,46,63,63,46,46,63,46,46,46,46,46,63,63,63,63,63,46,46,63,46,46,63,63,46,63,63,46,63,46,63,63
      63,46,63,63,63,63,63,63,63,63,63,46,63,63,63,63,63,46,63,63,63,46,63,63,46,63,63,46,63,46,63,63
      63,46,46,46,46,46,63,46,63,63,63,46,63,63,63,63,63,46,63,63,63,46,63,63,46,63,63,46,63,46,63,63
      63,46,63,63,63,63,63,46,63,63,63,46,63,63,63,63,63,46,63,63,63,63,63,63,46,63,63,63,63,46,63,63
      63,46,63,63,63,46,63,46,63,63,63,46,46,46,46,46,46,46,46,46,46,46,46,46,46,46,46,46,46,46,63,63
      63,46,46,46,46,46,63,46,63,63,63,63,63,63,63,63,63,63,63,63,63,46,63,63,63,63,63,63,63,63,63,63
      63,46,63,63,63,63,63,46,63,63,63,63,63,63,63,63,63,63,63,63,63,46,63,63,63,63,63,63,63,63,63,63
      63,46,63,63,63,63,63,46,63,63,63,63,63,63,63,63,63,63,63,63,63,46,63,63,63,63,63,63,63,63,63,63
      
[layer1]
map = 63,63,63,63,63,46,63,63,63,63,63,63,63,63,63,63,46,63,63,63,63,63,63,63,63,63,63,63,63,63,63,63
      63,63,63,63,63,63,63,63,63,63,63,63,63,63,63,63,46,63,63,63,63,63,63,63,63,63,63,63,63,63,63,63
      63,63,63,63,63,46,46,46,46,46,46,46,46,46,46,46,46,46,46,46,46,46,46,46,46,46,46,46,46,46,46,63
      63,63,63,63,63,46,63,63,63,63,63,63,63,63,63,63,63,63,63,63,63,63,63,63,63,63,63,63,63,63,63,63
      63,46,46,46,46,46,63,63,63,63,63,63,63,63,63,63,63,63,63,63,63,63,63,63,63,63,63,63,63,63,63,63
      63,46,63,63,63,63,63,46,46,46,46,63,46,46,46,46,46,46,46,46,46,46,46,46,46,46,46,46,63,46,46,46
      63,63,63,63,63,63,63,46,63,63,46,63,63,63,63,63,63,46,63,63,63,63,63,63,46,63,63,46,63,46,63,63
      63,46,46,46,46,46,46,46,63,63,46,63,63,63,63,63,63,46,46,46,46,63,63,63,46,63,63,46,63,46,63,63
      63,63,63,63,63,63,63,63,63,63,46,63,63,63,63,63,63,46,63,63,63,63,63,63,46,63,63,46,63,46,63,63
      63,46,63,63,63,63,63,63,63,63,46,63,63,63,63,63,63,46,63,46,46,46,46,46,46,63,63,46,63,46,63,63
      63,46,46,46,46,63,46,46,46,46,46,63,63,63,63,63,63,46,63,63,46,63,63,63,63,63,63,46,63,46,63,63
      63,46,63,63,46,63,46,63,63,63,46,46,46,46,46,46,63,46,46,63,46,63,63,63,63,63,63,46,63,46,63,63
      63,46,63,63,46,63,46,63,63,63,63,63,63,63,63,63,63,63,63,63,46,63,63,63,63,63,63,46,63,46,63,63
      63,46,63,63,46,63,46,46,46,46,46,46,46,46,46,46,63,46,46,46,46,46,63,46,46,63,63,46,63,63,63,63
      63,46,63,63,46,63,63,63,63,63,63,46,63,63,63,63,63,63,63,63,63,63,63,63,46,63,63,46,63,46,63,63
      63,46,63,63,46,63,63,63,63,63,63,46,63,63,63,63,63,63,63,63,63,46,63,63,46,63,63,46,63,46,63,63
      63,46,63,63,46,46,63,46,46,46,46,46,63,63,63,63,63,46,46,63,46,46,63,63,46,63,63,46,63,46,63,63
      63,46,63,63,63,63,63,63,63,63,63,46,63,63,63,63,63,46,63,63,63,46,63,63,46,63,63,46,63,46,63,63
      63,46,46,46,46,46,63,46,63,63,63,46,63,63,63,63,63,46,63,63,63,46,63,63,46,63,63,46,63,46,63,63
      63,46,63,63,63,63,63,46,63,63,63,46,63,63,63,63,63,46,63,63,63,63,63,63,46,63,63,63,63,46,63,63
      63,46,63,63,63,46,63,46,63,63,63,46,46,46,46,46,46,46,46,46,46,46,46,46,46,46,46,46,46,46,63,63
      63,46,46,46,46,46,63,46,63,63,63,63,63,63,63,63,63,63,63,63,63,46,63,63,63,63,63,63,63,63,63,63
      63,46,63,63,63,63,63,46,63,63,63,63,63,63,63,63,63,63,63,63,63,46,63,63,63,63,63,63,63,63,63,63
      63,46,63,63,63,63,63,46,63,63,63,63,63,63,63,63,63,63,63,63,63,46,63,63,63,63,63,63,63,63,63,63
      

